aNum —  номер A, оплачивающий услуги;
accFileChangeJournal — журнал смены учётного дела. См. Приложение «Журнал смены учетного дела».
accRechargeNtfThreshold — минимальная сумма пополнения для отправки уведомления.
accessNumber — номер доступа;
accountBalance — текущий баланс на карте;
accountContractId — идентификатор контракта создания счета.
accountCreatedDt — дата создания счета;
accountCurrency — валюта счета;;
accountFirstTransactionDt — дата первой операции по счету;
accountId — идентификатор банковского счета;
accountLastTransactionDt — дата последней операции по счету;
accountLimit — ограничение по карте;
accountType — тип счета, см. Приложение «Тип счета»;
account_id — счет, на который заказывается услуга.
accountingFile — учётное дело. См. Приложение «Учётное дело»;
accountingFileChangeHistory — история смены учётного дела;
accountingFileId — идентификатор учетного дела;
accountingFileName — наименование учётного дела;
activationCodeState — необходимое состояние кода;
additionalInfo — дополнительное описание, формат: key[=value];
address — адрес проживания;
amount — сумма корректировки; Примечание — Значение положительно для пополнения счета.
amount — сумма перевода;
apartment — номер квартиры;
appSessionId — идентификатор сессии;
appSubType
appVendor — поставщик приложения;
appVersion — версия приложения;
area — район;
areaId — идентификатор области;
bNum — номер B;
bNumber — дом;
balance — текущий баланс счёта;
balanceAmount — заданная сумма;
balanceChangeValue — изменение баланса счета;
balanceChangeValueFilter — фильтр по сумме изменения баланса счёта;
balanceIncFlag — флаг увеличения баланса;
balanceOnDayStart — баланс счёта на начало суток;
balanceOnMonthStart — баланс счёта на начало месяца;
balanceThresholdLimit — минимальный порог баланса для уведомления;
bankDetails — банковские реквизиты юридического лица, см. Приложение «Банковские реквизиты»;
bankName — наименование банка;
baseRate — курс относительно основной валюты;
baseServiceCode — код базового типа сервиса;
baseVolume — предоставленный объем услуги;
batchNumber — номер пакетного задания;
bik — БИК;
billCurrency — валюта стоимости услуги;
billDate — дата платежа;
billService — тип сервиса тарификации;
billServiceId — идентификатор типа услуги;
billVolume — протарифицированный объём предоставленной услуги;
billingMode — тип оплаты, см. Приложение «Тип оплаты»;
birthDt — дата рождения;
cardActivatedDt — дата активации карты;
cardExpiredDt — дата окончания срока действия карты;
cardFirstTransactionDt — дата первой транзакции по карте;
cardGroupTree — дерево группы карт;
cardId — идентификатор SIM-карты;
cardIds — список идентификаторов карт;
cardMsisdn — номер телефона, прявязанный к карте;
cardNumber — номер карты;
cardOperativeState — оперативное состояние карты, см. Приложение «Оперативное состояние карты»;
cardOperativeStateChangeHistory — история смены оперативного состояния карты;
cardOperativeStateChangeJournal — журнал смены оперативного состояния карты;
cardSaledDt — дата продажи карты;
cardState — административное состояние карты, см. Приложение «Административное состояние карты»;
card_group_id — идентификатор группы карт;
card_id — идентификатор карты абонента;
citizenship — гражданство.
clientId — идентификатор клиента;
clientIds — список идентификаторов клиентов;
clientType — тип клиента, см. Приложение «Тип клиента»;
client_id — идентификатор клиента;
code — код сервиса тарификации;
code — код учетного дела;
code — международное трехбуквенное обозначение валюты;
code — тип платежной системы, см. Приложение «Тип платёжной системы».
comment — комментарий.
companyName — название организации; (в случае юр. лица);
compareOperation — операция сравнения;
connected-network-operator-and-country — параметры оператора и страны;
containerId — идентификатор контейнера;
containerType — тип контейнера;
contractExpiredDt — дата окончания действия договора;
contractId — идентификатор контракта на открытие счёта;
contractInfo — дополнительная информация к контракту;
contractNumber — номер договора по документу;
contractPromotionCode — код акции;
contractSignedDt — дата подписания договора;
corrAccount — корреспондентский счёт;
corr_type — тип корректировки, см. Приложение «Тип корректировки»;
count — количество генерируемых кодов в запросе, обязательный параметр;
countryName — название страны;
createdDt — дата создания записи о клиенте;
createdDt — дата создания счёта;
createdDt — дата создания учетного дела;
currency — параметры валюты;
currencyCode — код валюты счета;
currencyId — валюта перевода;
currency_id — валюта корректировки;
currentAttemptCount — количество завершенных попыток выполнения;
currentStatus — текущий статус, см. п. 2.1 «Статусы запроса»;
deJureAddress — юридический адрес, см. Приложение «Данные об адресе»; Примечание — Заполняется только для юридических лиц.
dealer_id — идентификатор дилера;
departmentCode — код департамента выдавшего регистрационного документа;
dest_account_id — счет, на который переводится сумма корректировки;
displayName — отображаемое имя;
displayOrder — порядковый номер валюты для отображения;
dmMmeHost — имя хоста MME;
dmMmeRealm — имя realm MME;
doneOperationDt — дата успешного выполнения;
eSpec
email — адрес электронной почты;
enableRecommendedDate — флаг включения расписания уведомлений;
enabledNotification — флаг оповещения о превышении ограничения;
enterCost — стоимость подключения;
entityId — идентификатор сущности;
entityTitle — наименование сущности;
entityType — тип сущности, см. Приложение «Тип сущности»;
entry — запись;
eventComment — дополнительный комментарий;
eventDate — дата события;
eventPath — цепочка отношений сущностей;
eventText — текстовое описание изменений;
eventType
excludeBillServices — исключенные сервисы;
expired_date — дата окончания работы кода;
externalContract — внешний договор счета;
externalContractDt — дата оформления внешнего договора;
externalId — идентификатор внешнего заказчика;
finCorrPeriod — период корректировки;
firstName — имя физического лица;
firstTransactionDt — дата первой операции по счёту;
fixedAmount — заданная сумма;
fixedDayMonth — день месяца уведомления;
fromDt — дата записи должна быть позже этой даты;
generated_date — дата генерации кода, по умолчанию — текущая дата;
geoPoint — параметры геоположения точки;
has-active-pdp-context — флаг передачи данных по GPRS;
iccId — идентификатор смарт–карты;
id — идентификатор валюты;
id — идентификатор единицы измерения услуги;
id — идентификатор записи;
id — идентификатор клиента;
id — идентификатор платежной системы;
id — идентификатор сервиса тарификации;
id — идентификатор учетного дела;
id — идентификатор физического лица;
id — уникальный идентификатор записи;
ignore_null_values — флаг пропуска полей со значением NULL вместо обнуления;
imei — номер IMEI аппарата;
imsi — номер IMSI абонента;
include_card_ids — флаг включения в ответ список привязанных к группе карт.
info2 — дополнительный комментарий;
info — информация об учетном деле;
info — комментарий;
initiator — инициатор действия «Инициатор»;
inn — ИНН;
invoiceId — идентификатор выставленного счета;
ip — IP–адрес инициатора действия;
isClosed — флаг вывода операций для завершенных сессий.
isPurged — флаг удаления данных из VLR;
isPurgedEpsMme — флаг удаления данных из MME;
isPurgedEpsSgsn — флаг удаления данных из SGSN;
isStatusOK — флаг вывода операций, завершившихся успешно;
korpus — корпус;
kpp — КПП;
lastBillAttempt — дата последней попытки снятия средств;
lastChargeDt — дата последнего списания по счету;
lastName — фамилия физического лица;
lastRechargeDt — дата последнего пополнения счета;
lastTransactionDt — дата последней операции по счёту;
lat — широта местоположения;
latest-gprs-session-time — время последней сессии GPRS;
latest-sms-session-time — время последней сессии передачи SMS;
latest-ussd-message-time — время последней сессии передачи USSD;
latest-voice-session-time — время последней сессии голосового вызова;
letterOfAttorney — сведения о доверенности; Примечание — заполняется только для юридических лиц при регистрации по доверенности;
limit — минимальный баланс (порог отключения);
limitShift
localStatus — статус сервиса для абонента;
locality — город/населенный пункт;
locationId — идентификатор местоположения;
locationName — название местоположения;
locationPrefix — префикс, по которому было определено местоположение;
loginType — тип логина пользователя;
lon — долгота местоположения;
long — идентификатор подписки;
mcc — мобильный код страны MCC;
measureUnit — единицы измерения услуги. Возможные значения:
measureUnitCode — код типа измерения услуги;
measureUnitId — идентификатор типа измерения услуги;
mnc — код мобильной сети MNC;
moneyExpenses — учтенные расходы по карте;
moneyLimit — ограничение по карте;
msisdn — мобильный номер абонента;
msisdn — мобильный номер абонента;
msisdnMask — маска номера абонента;
msrn — номер MSRN;
name — наименование зоны;
name — ФИО;
name — название валюты;
name — название единицы измерения услуги;
name — название учетного дела;
network-type — тип сети;
newAccountBalance — баланс счета после операции;
newOperativeState — новое оперативное состояние карты, см. Приложение «Оперативное состояние карты»;
nextBillAttempt — дата следующей попытки снятия средств;
nextPeriodCost — размер следующего списания средств за услугу; 
nextTryDt — дата следующей попытки выполнения;
notSearchMsisdnByAccountIndex — флаг запроса счетов по msisdnMask (в main db), а затем журналов, по умолчанию false;
numberState — административное состояние номера, см. Приложение «Состояние подписки»;
o	TIME — количество времени;
o	TRAFFIC — объем трафика;
o	UNIT — штука.
ogrn — ОГРН;
okpo — ОКПО;
oldAccountBalance — баланс счета до операции;
oldOperativeState — предыдущее оперативное состояние, см. Приложение «Оперативное состояние карты»;
oldOperativeState — старое оперативное состояние карты, см. Приложение «Оперативное состояние карты»;
operation — операция над сущностью «Операция над сущностью»;
operatorName — имя оператора SPN;
orderNumber — уникальный номер заказа, используемый для всех действий с подпиской;
order_code — код продукта, обязательный параметр;
packageId — идентификатор пакета;
packageName — название пакета;
packageRest — остаток по пакету;
packages — пакеты услуг;
page_num — номер страницы;
page_size — размер страницы;
partition — номер партии, обязательный параметр;
passport — номер паспорта;
paymentDt — дата проведения платежа;
payment_rec_dt — дата-время журнальной записи платежа (yyyy-MM-dd HH:mm:ss.SSS);
payment_rec_id — идентификатор журнальной записи платежа;
periodEnd — дата окончания использования счетчика;
periodStart — дата начала использования счетчика;
person — информация о физическом лице;
personalManager — имя персонального менеджера;
phone — контактный телефон;
pin1 — новый PIN1;
pin2 — новый PIN2;
placeOfBirth — место рождения;
point — параметры точки;
pool_id — идентификатор пула;
postcode — почтовый индекс;
precision — количество значащих знаков после запятой;
productId — идентификатор продукта;
productName — название продукта;
productRest — остаток по продукту;
product_id — идентификатор продукта, обязательный параметр;
provCode — код provisioning;
puk1 — новый PUK1;
puk2 — новый PUK2;
purgedDt — дата удаления данных из VLR;
purgedEpsMmeDt — дата удаления данных из MME;
purgedEpsSgsnDt — дата удаления данных из SGSN;
radius — радиус зоны;
realVolume — действительный объем услуги в пакете; Примечание — Если значение "-1", то пакет не ограниченный.
recordDate — дата внесения записи;
regAddress — адрес регистрации, см. Приложение «Данные об адресе»; Примечание — Заполняется только для физических лиц.
regDocExpiredDt — дата окончания действия регистрационного документа;
regDocIssuePlace — место выдачи регистрационного документа;
regDocIssuedDt — дата выдачи регистрационного документа;
regDocNumber — номер паспорта РФ; Примечание — Заполняется только при регистрации по паспорту РФ;
regDocSeries — номер серии паспорта РФ; Примечание — Заполняется только при регистрации по паспорту РФ;
regDocType — тип регистрационного документа, см. Приложение «Тип регистрационного документа»;
regDocTypeInfo — название документа;
region — регион;
registered-on-dm-mme — флаг регистрации в VLR;
registered-on-dm-sgsn-lte — флаг регистрации в VLR;
registered-on-sgsn — флаг регистрации в VLR;
registered-on-vlr — флаг регистрации в VLR;
registeredDt — дата регистрации на VLR/SGSN; 
registrationContractId — идентификатор контракта регистрации абонента;
remainingVolume — остаток объема услуги в пакете;
remoteServiceInfo — информация о сервисе;
remoteServices — сервисы удаленного доступа;
remoteStatus — статус сервиса удаленного доступа;
remoteStatusError — полученная ошибка.
renewalSubscriptionDate — дата обновления подписки
restStatus — текущее состояние подписки. Возможные значения см. Приложение «Статус подписки».
result — итог выполнения команды;
riskLevelId — уровень риска;
secondName — отчество физического лица;
serviceCost — стоимость сервиса;
serviceCostFilter — фильтр по стоимости услуги;
serviceInfo — информация о сервисе;
serviceVolume — объем предоставленной услуги;
serviceVolumeFilter — фильтр по объёму предоставленной услуги;
sessionJournal — фильтр для поиска, см. Приложение «Журнал операций по сессиям»;
sessionStartDt — дата и время начала сессии;
settlAccount — расчётный счёт;
sex — пол, см. Приложение «Пол»;
sgsn — номер SGSN;
simCardActivationCode — код активации SIM-карты.
simType — тип SIM-карты;
simVendor — поставщик SIM-карты;
skip_subscription_card_check — флаг пропуска проверки карты подписки.
sortColumns — колонки, по которым нужна сортировка;
sortSchema — схема сортировки результатов поиска;
sortType — тип сортировки. Возможные значения см. Приложение «Тип сортировки при поиске»
src_account_id — счет, с которого переводится сумма корректировки;
startSubscriptionDate — дата начала подписки;
state — административное состояние учетного дела. Возможные значения см. Приложение «Административное состояние карты»;
state — состояние карты, см. Приложение «Оперативное состояние карты»;
state — состояние подписки, см. Приложение «Состояние подписки»;
status — статус OCS;
status — текущий статус выполнения команды.
street — улица;
string — код активации;
subscriptionId — идентификатор подписки на услугу;
sumUnpaidInvoices — итоговая сумма по неоплаченным счетам;
tariffId — идентификатор тарифа;
tariffPlanId — идентификатор тарифного плана;
tariffPlanName — наименование тарифного плана;
taskId — идентификатор задачи в очереди;
text — текст сообщения;
tillDt — дата создания записи должна быть до этой даты;
totalCount — максимально возможное количество результатов;
totalVolume — заявленный объем услуги в пакете; Примечание — Если значение "-1", то пакет не ограниченный.
transactionId — идентификатор транзакции в платёжной системе;
trigger_id — идентификатор триггера;
type — тип операции, см. Приложение «Операция над сущностью»;
types — список операций, см. Приложение «»;
tzoneId — идентификатор тарифной зоны;
tzoneName —  название тарифной зоны;
tzonePrefix — префикс направления (B), по которому была определена тарифная зона;
unpaidAmount — неоплаченная сумма;
userId — идентификатор пользователя;
userLogin — логин пользователя;
user_name — имя пользователя карты;
ussd — текст USSD–запроса;
virtualGroupId — идентификатор виртуальной группы;
virtual_group_id — идентификатор виртуальной группы;
vlr — номер VLR;
volumeTypeId — идентификатор единицы измерения услуги;
volumeTypeName — название единицы измерения услуги;
vpnId — идентификатор VPN;
vpnTypeId — идентификатор типа VPN;
with_reserved — вернуть ли информацию о зарезервированных средствах (по умолчанию false);
withoutLock — флаг возможности овердрафта без блокировки счета;
tax_id — идентификатор налога;
description — описание налога;
active_till — дата окончания действия налога;
registrant — имя регистрируемого пользователя;
login — логин для авторизации;
password — пароль для авторизации;
role — роль пользователя;
id — идентификатор роли пользователя;
profileId — идентификатор профиля;
checkPasswordExpired — флаг проверки продолжительности использования пароля;
targetCompanyId
login_id — идентификатор логина;
createdDt — дата и время создания логина. Формат: YYYY–MM–DD hh:mm:ss.mss;
virtualGroupId — идентификатор виртуальной группы ролей;
roleName — название роли;
roleInfo — дополнительная информация о роли;
roleClass — класс роли;
scope
profileName — имя профиля;
profileInfo — дополнительная информация о профиле;
maxRequestsPerHour — максимальное количество запросов в течение часа;
maxRequestsPerDay — максимальное количество запросов в течение суток;
appConfig
Clients — параметры клиентов;
Name — имя физического/название юридического лица;
FullName — полное имя физического/полное название юридического лица;
INN — номер ИНН;
KPP — номер КПП;
Type — тип клиента. Возможные значения: ФизическоеЛицо/ЮридическоеЛицо.
ClientID — идентификатор клиента;
Contracts — параметры контрактов;
ContractID — идентификатор контракта;
ContractNumber — номер контракта;
ContractDate — дата заключения контракта в формате ISO. Формат: YYYY–MM–DDThh:mm:ss;
Contacts — параметры контактной информации;
ActualAddress — параметры фактического местонахождения;
Email — адрес электронной почты;
MailingAddress — адрес корреспонденции;
postcode — почтовый код;
region — название области;
area — областный район;
locality — название населенного пункта;
street — название улицы;
full — полный адрес. Формат: postcode + region + area + locality + street;
PhoneNumber — номер телефона. Формат: +X (XXX) XXXXXXX или +XX (XXX) XXXXXXX;
successfully — флаг успешного создания или изменения клиента;
ID — идентификатор клиента;
Error — код ошибки;
Sum — сумма перевода;
NDS — тип налоговой ставки;
SumNDS — сумма уплаченного налога;
PaymentID — идентификатор транзакции;
period — период действия скидки;
amount — количество временных промежутков;
timeUnit — наименование временного промежутка;
priority — приоритет скидки;
rules — параметры правил;
discountRule — правило действия скидки;
ratePercent — доля цены, на которую уменьшается стоимость;
unit — наименование временного промежутка;
rulePriority — приоритет правила;
